"a" = (/turf/liquid/water{tag = "icon-Water1"; icon_state = "Water1"},/area)
"b" = (/turf/liquid/water{tag = "icon-Water2"; icon_state = "Water2"},/area)
"c" = (/turf/ground/sand{tag = "icon-sand3"; icon_state = "sand3"},/area)
"d" = (/turf/ground/sand{tag = "icon-sand2"; icon_state = "sand2"},/area)
"e" = (/turf/ground/sand{tag = "icon-sand1"; icon_state = "sand1"},/area)
"f" = (/turf/ground/fertile/grass{tag = "icon-grass1"; icon_state = "grass1"},/turf/edge{tag = "icon-Shale (NORTH)"; icon_state = "Shale"; dir = 1},/turf/edge{tag = "icon-Shale (WEST)"; icon_state = "Shale"; dir = 8},/turf/edge{tag = "icon-Shale (EAST)"; icon_state = "Shale"; dir = 4},/area)
"g" = (/turf/ground/fertile/grass{tag = "icon-grass1"; icon_state = "grass1"},/turf/edge{tag = "icon-Shale (NORTH)"; icon_state = "Shale"; dir = 1},/turf/edge{tag = "icon-Shale (WEST)"; icon_state = "Shale"; dir = 8},/area)
"h" = (/turf/ground/fertile/grass{tag = "icon-grass1"; icon_state = "grass1"},/turf/edge{tag = "icon-Shale (NORTH)"; icon_state = "Shale"; dir = 1},/area)
"i" = (/turf/ground/fertile/grass{tag = "icon-grass1"; icon_state = "grass1"},/turf/edge{tag = "icon-Shale (NORTH)"; icon_state = "Shale"; dir = 1},/turf/edge{tag = "icon-Shale (EAST)"; icon_state = "Shale"; dir = 4},/area)
"j" = (/turf/ground/fertile/grass{tag = "icon-grass1"; icon_state = "grass1"},/turf/edge{tag = "icon-Shale (WEST)"; icon_state = "Shale"; dir = 8},/area)
"k" = (/turf/ground/fertile/grass{tag = "icon-grass1"; icon_state = "grass1"},/area)
"l" = (/turf/ground/fertile/grass{tag = "icon-grass1"; icon_state = "grass1"},/turf/edge{tag = "icon-Shale (EAST)"; icon_state = "Shale"; dir = 4},/area)
"m" = (/turf/wall/decWall{tag = "icon-Shale"; icon_state = "Shale"},/area)
"n" = (/turf/ground/fertile/grass{tag = "icon-grass1"; icon_state = "grass1"},/turf/edge{tag = "icon-Shale (WEST)"; icon_state = "Shale"; dir = 8},/turf/edge{tag = "icon-Shale (EAST)"; icon_state = "Shale"; dir = 4},/area)
"o" = (/turf/ground/fertile/grass{tag = "icon-grass1"; icon_state = "grass1"},/turf/edge{tag = "icon-Shale (WEST)"; icon_state = "Shale"; dir = 8},/turf/edge{tag = "icon-Shale (NORTH)"; icon_state = "Shale"; dir = 1},/area)
"p" = (/turf/ground{tag = "icon-grass1"; icon_state = "grass1"},/area)
"q" = (/turf/ground/sand{tag = "icon-sand1"; icon_state = "sand1"},/turf/edge{tag = "icon-Shale (WEST)"; icon_state = "Shale"; dir = 8},/turf/edge{tag = "icon-Shale (EAST)"; icon_state = "Shale"; dir = 4},/area)
"r" = (/light_obj/Campfire,/turf/ground/sand{tag = "icon-sand3"; icon_state = "sand3"},/area)

(1,1,1) = {"
aaaaaaaaaaaaabbaaaaaaaaaaaaaaaaaaaaaaaaabaaaabaaaaaaaaaaaabbbaaaaaaaaaaaaaaaaabbaaaaaaaaaaaaaaaaaaaa
aaaaaaaaaaaaababaaaaaaaaaaaaaaaaaaaaaaaabaaaaaaaaaaaaaaaabbbbaaaaaaaaaaaaaaaababaaaaaaaaaaaaaaaaaaaa
aabbbaaaaaabaaabaaaaaaaaaaaaaaaaaaaaaaabaaaaaabaaaaabbbbbbaaaaaaaaaaaaaaaaaaabbbbaaaaaaaaaaaaaaaaaaa
aabbbaaaaaabaaabbbbaaaaaaaaaaaaaabbbbaabaaaaabaaabbbbbbbaaaaabbaaabbaaaaaaaaabbaabaaaaaaaaaaaaaaaaaa
aabbbaaaaaabbbbbaabaaaaaaabbbabbbbbbbaabaaaabaaaabbabbbaabbbbbbbbbaaaaaaaaaabbbaabbaaaaaaaaaaaaaaaaa
aabbbaaaaabbabbaaabaaaaaabaaaaaabbbbabbaaaaaaaaaaaaabbbbbaaaaabbaaaaaaaaaaaabbbaabbaaaaaaaaaaaaaaaaa
aaaabaaaababbbaaabbaaaaaaaaaaaabbaabbabaaaabaaaaaaaaaabaaaaaaaaaaaaaaaaacaababaaabbaaaaabbbbbbaaaaaa
aababaaaaaabbbaabaaaaaaaabaaaaabbabbaaabbbbaaaaaaaaaaabaaaaaaaaaaaaaaaccccababbbbbbbbbbbbbbbaabaaaaa
aababbaaabbbbbbbbaaaaaaabaaaaaabaabbaaaaaaaaaaaaaaaaaabbaaaaaaaaaaaaacccccabbabbbaaaaaabababbbbaaaaa
aaababaaabbbbbbaabaaaaaabaaaaaababbabaaaaaaaaaaaaaaaabbbbbbaaaaaaaaacccccccaaaaaaaaaaabaababbbaaaaaa
aaaaabaaabbbaaabbbbaaabbaaaaaaababbbbaaaaabbaaaaaaaabbaaabbbaaaaaacccccdccccaaaaaaaaaabaababbbaaaaaa
aaaaabbbbbbbaaaaaaabbbaaaaaaaaabbabbaaaaababaaaaaaabbaaaababaaaaaacccecdeeccaaaaaaaaaabaababbaaaaaaa
aaaaaaaaaaaaaaaaaaaaaaaaaaaaaaaabbbbaaaaababaaaaaabbbaaabbbbaaaaaacceeddeeeccaaaaaaaaaabababbaaaaaaa
aaaaaaaaaaaaaaaaaaaaaaaaaaaaaaaaabaaaaabbaaaaaaaaaaabaabbabbaaaaaaaceeddeeeccaabbbbabbbbaabaaaaaaaaa
aaaaaaaaaaaaaaaaaaaaaaaaaaaaaaaaabababaaaaabaaaaaaaabbbaaabaaaaaaaaceeddeeecccbaaabbbaaaaaaaaaaaaaaa
aaaaaaaaaaaaaaaaaaaaaaaaaaaaaaaabbbaaaaaaabbaaaaaaaaaaaaaaaaaaaaaaaceccdeeeeccbaabaabaaaabbaabbaaaaa
aaaaaaaaaaabbaaaabbbbbaabbbbbabbabaaaaaaaabaaaaaaaaaaaaaaaaaaaaaaaccccdcdeeecccaabbbbaaaaabbbbbbaaaa
aaaaaaaaaabbbbbbbbbabbbbbbbbaaaaaaabaaaaabbaaaaaaaaaaaaaaaaaaaaaaaeecededceeeccabbabbbaaaabbbbbbaaaa
aaaaaaaaaabbbabbaaaaaaaabbbbaaaaaaaabaaabbaaaaaaaaaaaaaaaaaaaaaaaceccddcceceeccababbbbbbbbabaaabbaaa
aaaaaaaaababbbbbaaaaaaaaabbbbaaaaaaaababaaaaaaaaaaabaaaaaaaaaaaaccedddceeccceccabbbaababaabbaaabbbaa
bbbaaaabbbbbbaaabbbbbabbbababaaaaaaaaaaaaaaaaabaabbbaaaaaaaaccccedddcceceeeeeccabbaaababaabbaaabbbaa
baababbbbbbbbbabbbaaaaaaabbbbaaaaaaaaaaaaaaaabbababbaaaaaaaacddddececccceeccccfabbaabaabaabbabbaabba
baabbababbaaababaaaaaaaaaaabbaaaaaaaaaaaaaabbbbbaabaaaaaaaaghhhhhiefccccecccccjiabbbaaabaabbbabbaaaa
babbaabbbbaaaabbaaaaaaaaaaaaaaaaaaaaabbaaababbaaabbaaaaaaagkkkkkkkhkhkkhcccccgklaaaabbbaababbbabaaaa
bbbaabbabbaaaaaabbaaaaaaaaaaaaaaaaaabbaabbabbaaaabaaaaaaagkkkkkkkkkkkkkkhiccgkklaaaaaaaabaabbbbaaaaa
bbabbababbaaaaababaaaaaaaaaaaaaaaaabbbabaabbaaaaaaaaaaaagkkkkkkkkkkkkkkkkkhhkkkkiaaaaaaabaaaaaaaaaaa
abbaaabaabaaaabaabaaaaaaaaaaaaaaaaabbbaaaaaaaaaaaaaaaaaajkkkkkkkkkkkkkkkkkkkkkkkkiaaaaaabaaaaaaaaaaa
aaaaaabaaaaaacccccccaaaaaaaaaaaabaaaaaaaaaaaaaaaaaaaaaagkkkkkkkkkkkkkkkkkkkkkkkkkkiaaaababbbaaaaaaaa
aaaaaabaaaaaccccccccaaaaaaaaaaaabaaaaaaaaaaabbaaaaaaaaajkkkkkkkkkkkkkkkkkkkkkkkkkkkiaaaabaabbaaaaaaa
aaaaaabbaaaaccdcccccaaaaaaaaabaabaaaaaaaaaaabbaabaaaaagkkkkkkkkkkkkkkkkkkkkkkkkkkkklaaabbbabaaaaaaaa
aaabbabbaaaaccdccccccaaaaaaaabbabaaaaaabbabbbbaaabaaagkkkkkkkkkkkkkkkkkkkkkkkkkkkklmbbbaabaabbaaaaaa
aaabbbbbbaaacdcedcccccaaaaaaaababaaaabbbbbbbbaaababghkkkkkkkkkkkkkkkkkkkkkkkkkkkklmmaabaaababaaaaaaa
aabababbbabbcdceedceeccaaaaaaaaabbabbbbbbbbbbaaaaabjkkkkkkkkkkkkkkkkkkkkkkkkkkkkklmaaabaaaabbaaaaaaa
aababaabbbaacdcceeeeccccaaaaaaaaaababbaababbaaaababjkkkkkkkkkkkkkkkkkkkkkkkkkkkkklbbaabbaaaabaaaaaaa
aabbaabbbaaafcdddcdcddcccaaaaaaaaaaaaaaabbbbaaaaabbmjkkkkkkkkkkkkkkkkkkkkkkkkkkkklbabbbbbbaabaaaaaaa
aabbababbaabnccccccccdddccccaaaaaaabaaaaabbbaaaaabbmmjkkkkkkkkkkkkkkkkkkkkkkkkkkkkiabbabbababaaaaaaa
aabbbaabaabajhhiccgicccdddccccaabbbbbaaaaabbaaaaaabbmjkkkkkkkkkkkkkkkkkkkkkkkkkkkkkibbbabbbbbaaaaaaa
aaaaaaaaaabajkkkkkkkhhiccdcccccbbbbbabaaaaaaaaaabbaagkkkkkkkkkkkkkkkkkkkkkkkkkkkkkkkiaaaaaabbaaaaaaa
aaaabbbaabaamjkkkkkkkkkiceeeccccccbbbabaaaaaaaaabaghkkkkkkkkkkkkkkkkkkkkkkkkkkkkkkkklaaaaaaabbaaaaaa
aaabbabaabaammjkkkkkkkkkhicdecccccccccccccccghhhhhkkkkkkkkkkkkkkkkkkkkkkkkkkkkkkkkkklbbbbbaaaabaaaaa
aaabbbbbbbaaammmjkkkkkkkkkiddeccccccccccccccjkkkkkkkkkkkkkkkkkkkkkkkkkkkkkkkkkkkkkklmaaaabaaaabaaaaa
aaabbabbaaaaabmmmjkkkkkkkklccceeeeeeeccccccgkkkkkkkkkkkkkkkkkkkkkkkkkkkkkkkkkkkkkkklmaaaabbbbbabaaaa
aababbbaaabbbbaammjkkkkkkkkicccccccceeeeccgkkkkkkkkkkkkkkkkkkkkkkkkkkkkkkkkkkkkkkkklaaaabbaaaabaaaaa
aababbbbbbbaabaaamjkkkkkkkkkhhhhiccccccccgkkkkkkkkkkkkkkkkkkkkkkkkkkkkkkkkkkkkkkkklmaaaaaaaababaaaaa
aabbaabaaaaaabaaaajkkkkkkkkkkkkkkhiccccccjkkkkkkkkkkkkkkkkkkkkkkkkkkkkkkkkkkkkkkkklmaaaaaabaabbaaaaa
aaaaaaaabbaaabaaghkkkkkkkkkkkkkkkkkhhhhhhkkkkkkkkkkkkkkkkkkkkkkkkkkkkkkkkkkkkkkkklmaaaaaaabbbbaaaaaa
aaaaaaabbbaaaabajkkkkkkkkkkkkkkkkkkkkkkkkkkkkkkkkkkkkkkkkkkkkkkkkkkkkkkkkkkkkkkkklmbaaaaaaaaaaaaaaaa
aaaaaabbbaaaaabgkkkkkkkkkkkkkkkkkkkkkkkkkkkkkkkkkkkkkkkkkkkkkkkkkkkkkkkkkkkkkkkkklbbaaaaaaaaaaaaaaaa
aaaaabbabaaaaabjkkkkkkkkkkkkkkkkkkkkkkkkkkkkkkkkkkkkkkkkkkkkkkkkkkkkkkkkkkkkkkkklmbbaaaaaaaaaaaaaaaa
aaaabbbbbbbbbagkkkkkkkkkkkkkkkkkkkkkkkkkkkkkkkkkkkkkkkkkkkkkkkkkkkkkkkkkkkkkkkklmmbbbaaaaaaaaaaaaaaa
aaaabbbbbaaaabjkkkkkkkkkkkkkkkkkkkkkkkkkkkkkkkkkkkkkkkkkkkkkkkkkkkkkkkkkkkkkklmmmabbbabaaaaabbaaaaaa
aaabbbbabbaaaajkkkkkkkkkkkkkkkkkkkkkkkkkkkkkkkkkkkkkkkkkkkkkkkkkkkkkkkkkkkkkklmmaaaaaabaaaabbaaaaaaa
aabaabbbbabaaajkkkkkkkkkkkkkkkkkkkkkkkkkkkkkkkkkkkkkkkkkkkkkkkkkkkkkmmmjkkkkklaaaaaaaabaaabbaaaaaaaa
aababbaaabbaahkkkkkkkkkkkkkkkkkkkkkkkkkkkkkkkkkkkkkkkkkkkkkkkkkkkkkmmmmmmjkkklaaaaaaaabaabbbaaaaaaaa
abaabaaaabbbhkkkkkkkkkkkkkkkkkkkkkkkkkkkkkkkkkkkkkkkkkkkkkkkkkkkkmmmmmmmmeklmmaaaaaaaababbbaaaaaaaaa
abaaaaaabbbgkkkkkkkkkkkkkkkkkkkkkkkkkkkkkkkkkkkkkkkkkkkkkkkklmmmmmmmmccmmemmmmaaaaaaaabbbbaaaaaaaaaa
aabaaaabaabjkkkkkkkkkkkkkkkkkkkkkkkkkkkkkkkkkkkkkkkkkkkkkkkklmmmmmmmcccdddmmmaaaaaaaaabbbaaaaaaaaaaa
aaabaaabaaajkkkkkkkkkkkkkkkkkkkkkkkkkkkkkkkkkkkkkkkkkkkkkkkklccccccccccdaaaaaaaaaaaaaaaabaaaaaaaaaaa
aaaabbbaaaajkkkkkkkkkkkkkkkkkkkkkkkkkkkkkkkkkkkkkkkkkkkkkkkklccccccccccaaaaaaaaaaaaaaaabaaaaaaaaaaaa
aaaaaaaaaaajkkkkkkkkkkkkkkkkkkkkkkkkkkkkkkkkkkkkkkkkkkkkkkkklcccccccccaaaaaaaaaaaaaaaaabaaabbaaaaaaa
aaaabaaaaabjkkkkkkkkkkkkkkkkkkkkkkkkkkkkkkkkkkkkkkkkkkkkkkkklaccccccaaaaaaaaaaaaaaaaaaabbbbbbaaaaaaa
aaabbaaabbajkkkkkkkkkkkkkkkkkkkkkkkkkkkkkkkkkkkkkkkkkkkkkkkklaaaaaaaaaaaaaaaaaaaaaaaaabbaaabaaabaaaa
aaabbaaabaajkkkkkkkkkkkkkkkkkkkkkkkkkkkkkkkkkkkkkkkkkkkkkkkklaaaaaaaaaaaaaaaabbaaaaabbbbaabbaabaaaaa
aaabbaabaaajkkkkkkkkkkkkkkkkkkkkkkkkkkkkkkkkkkkkkkkkkkkkkkkklaaaaaaaaaaaaaaabbaaaaabababaabaabbaaaaa
aaabbaabaagkkkkkkkkkkkkkkkkkkkkkkkkkkkkkkkkkkkkkkkkkkkkkkkkklaaaaaaaaaaaaaabbaaaaabbbababbaaabaaaaaa
aaabaaabagkkkkkkkkkkkkkkkkkkkkkkkkkkkkkkkkkkkkkkkkkkkkkkkkkklaaaaaabaaaaaabbaaaabbabaababbaabaaaaaaa
aaabbbaghkkkkkkkkkkkkkkkkkkkkkkkkkkkkkkkkkkkkkkkkkkkkkkkkkkklaaaaaabaaaabbbaaaaabaabaabbababbabbaaaa
aaabaaajkkkkkkkkkkkkkkkkkkkkkkkkkkkkkkkkkkkkkkkkkkkkkkkkkkkklaaaaaabaaabbbbaaaaaaabaaabbbabaaabaaaaa
aabbbbgkkkkkkkkkkkkkkkkkkkkkkkkkkkkkkkkkkkkkkkkkkkkkkkkkkkkklaaaaabaaabbbbaaaaaaabbaabbbabaaaabaaaaa
aabbabjkkkkkkkkkkkkkkkkkkkkkkkkkkkkkkkkkkkkkkkkkkkkkkkkkkkkklaaaabbaabbbbaaaaaaaabbbbabaabbaabbaaaaa
aabaaokkkkkkkkkkkkkkkkkkkkkkkkkkkkkkkkkkkkkkkkkkkkkkkkkkkkklmaaaababbbbbaaaaaaaaaabaabbbbbbaaabbaaaa
aabaajkkkkkkkkkkkkkkkkkkkkkkkkkkkkkkkkkkkkkkkkkkkkkkkkkkkklmmaaaabbaabaaaaabaaaaabaaabbaaabaaabaaaba
aaaaajkkkkkkkkkkkkkkkkkkkkkkkkkkkkkkkkkkkkkkkkkkkkkkkkkkkklmaaaaaaaaaaaaaaabaaaabaaaaaaaaabaabaaaaab
aaaaajkkkkkkkkkkkkkkkkkkkkkkkkkkkkkkkkkkkkkkkkkkkkkkkkkkklmaaaaaaaaaaaaaaabaaaabaaaaaaaaaabaabaaaaaa
aaaaajkkkkkkkkkkkkkkkkkkkkkkkkkkkkkkkkkkkkkkkkkkkkkkkkkklmmaaaaaaaaaaaaaaabaabbbaaaaaaaaaabaabaaaaaa
aaaaamkkkkkkkkkmmmkkkkkkkkkkkkkkkkkkkkkkkkkmmmjkkkkkkkkklmaaaaaaaaaaaaaaaabbbbbaaaaaaaaaaabaabaaaaaa
aaaabmmmmkkkkmmmmmmkkkkpppkkkkkkkkkkkkkkkkmmmmmjkkkkkkklmaaaaaabaaaaaaaaabbbbbbaaaaabaaabbbbbbaaaaaa
aaabbbmmmmkkmmmmmmmkkkpppppkkkmmmmmmmmmmmmmmmmmmmmjkkklmmaaaaabbaaaaaaaaaaabbabbbbbbbabaaabbbaaaaaaa
aaabbbbbmmmmmmmccmmmkpppppppkmmmmmmmmmmmmmmmcmmmmmmjmmmmaaaaabbaaaaaaaaaaaabaaaabaababaabbbbbaaaaaaa
aabaabbbbmmmmddcccmmmmmmqmmmmmmmccccccmmmmccccccccmmmmmaaaaaabaabbaaaaaaaaaaaaaabbababbbbbbbbaaaaaaa
aabbbaabbbbddddccccmmmmmqmmmmmmcddccccccccccccccccmmmaaaaaaabbbbbbaaaaaaaaaaababbabbbabbabbabaaaaaaa
abbaaaabaaaabaacecccccccccccccccdddedddcccceecccaaaaaaaaaaaaaaaabbaaaaaaaaaabbbaaaaaababbaaabaaaaaaa
bbbbbabbaaaabaaaceeccccccccccceccdcccceddcceeccaaaaaaaaaaaaaaaaabaaaaaaaabbbbaaaaaabbabbaaaabaaaaaaa
aaaababaaaaaabaaaceeeccccccccecddccaacccecceccaaaaaaaaaaaaaaaaabaaaaaaaabbbbaaaaaabbbbaaaaaabaaaaaaa
aaaababaaaaaabaaaaccceeeercceddcaaaaaacccececcaaaaaaaaaaaaaaaaabbbbbbabbbbbbaaaaaabbaaaaaaabaaaaaaab
aaaabbaaaaaaabaaaaccccceccceeccaaaaaaaaacceeccaaaaaaaaaaaaaaaaaaaaaaaaaaabbaaaaaaaabaaaaaabbaaaabbba
aaaabbaaaaaaaabaabbbcccceceeeccaaaaaaaaaacccccaaaaaaaaaaaaaaaaaaaaaaababbbaaaaaaaaaababbbbbbaaabaaaa
aaaabaaaaaaaaabbbaaaaacceeccccaaaaaaaaaaacccccaaaaaaaaaaaaabbbabbabbbbbbaaaaaaaaaaaabbbbabbaaabaaaaa
aaabaaaaaaaaaaaaaaaaaaccccccccaaaaaaaaaaacccccaaaaaaaaaabbbbbbbbbbaaaaaaaaaaaaaaabbbbbabbbaaabaaaaaa
aaabaaaaaaaaaaaaaaaaaaaccccccaaaaaaaaaaaaacccaaaaaaaaaabaaaaaaaaaaaaaaaaaaaaaaaabbbbaabbbababaaaaaaa
aabbaaaaaaaaabaaaaaaaaaaaaaaaaaaaaaaaaaaaaaaaaaaaaaaaabaaaaaaaaaaaaaaaaaaaaaaaaabbbaaabbbbaaaaaaaaaa
aabbaaaaabbbbbaaaaaaaaaaaaaaaaaaaaaaaaaaaaaaaaaaaaaaabaaaaaaaabbbbbbbaaaaaabbaababaaabbbaaaaaaaaaaaa
abaabbbbbaaabaaabaaaaaaaaaaaaaaaaaaaaaaaaaaaaaaaaaaabaaaaaabbbbaaaaabbabbbaabbaabbaaabaaaaaaaaaaaaaa
baabbaaaaaabbabbbaaaaaaaaaaaaaaaaaaaaaaaabbbbbaaabbbaaaaabbbbaaabbabbabbbbbbbaabaaaabaaaaaaaaaaaaaaa
bbbabaaaaabbbbaabaaaabbbaaaaaaaaaaaabbbabaaabbabbbbaaaaaaabbbbbaaabbaaaaaaabaabbaaaabbbbbbbbaaaaaaaa
baaabbaaabbbbaaabbbbbaaaaaabaaaaaaaabbbbbbbbbbbbababbbbaaaaaaaabbabbbbaaaabbbbaaaaabbbbababaaaaaaaaa
aaaaabbbbbbbaabbbbabbabbabbbbaaaaaaabbaaaabbbbbbbbaabbbbbaaabbbbbbaaabbaababbabbbbbabbabbbbaaaaaaaaa
aaaaaaabbbbbbbbbabbabbbbbbbaaaaaaabbbaaaaaaaaaabbabbbbbaabababbbbaaaababbbbbbbaaaaabbababbaaaaaaaaaa
aaaaaaabbaaaaaaaabaaabbbaabbbbbbbbaaaaaaaaaaaababbbabbbbbaaaaaaaaaaaabaaabbaaaaaabbbbbababaaaaaaaaaa
aaaaaaaaaaaaaaaaabbbbaaaaaaaaabbaaaaaaaaaaabbbbbbaaaaaaaaaaaaaaaaaaaaaaabbaaaaaabbbbbbbbbbaaaaaaaaaa
"}
